####################
#..#.............K##
#..#..............##
#..#######..########
#..#######M.......##
#..##....#........##
#..##....#..####..##
#..##.E..D..#.....##
#..##....#..#.....##
#.P##....####..#..##
#..##....#.....#..##
#..#######.....#..##
#..#######..####..##
#.....#.....#..#..##
#.....#.....#..#..##
####..#..####..#..##
#........#........##
#........#........##
####################
####################