############################################################
#.....#.................#..#.......................#.....###
#.....#.................#..#.......................#.....###
####..#######..#######..#..#..#..####..##########..#..#..###
#..#........#..#.....#..#..#..#.....#..#........#..#..#..###
#..#........#..#.....#..#..#..#.....#..#........#..#..#..###
#..#######..#..#..####..#..#..####..####..####..####..#..###
#........#.....#..#.....#..#.....#...........#........#..###
#........#.....#..#.....#..#.....#...........#........#..###
#..####..#######..#..####..#..#######..#######..#######..###
#..#........#.....#.....#..#..#.....#..#.....#..#........###
#..#........#.....#.....#..#..#.....#..#.....#..#........###
#..#######..#..#..####..#..#..#..#..####..#..####..####..###
#.....#..#.....#..#..#..#.....#..#........#..#.....#.....###
#.....#..#.....#..#..#..#.....#..#........#..#.....#.....###
####..#..#######..#..#..#######..##########..#..####..######
#.....#........#..#..#...........#.....#.....#..#..#.....###
#.....#........#..#..#...........#.....#.....#..#..#.....###
#..#######..#..#..#..#############..####..####..#..####..###
#..#.....#..#...........#..#........#.....#.....#.....#..###
#..#.....#..#...........#..#........#.....#.....#.....#..###
#..#..#..#############..#..#..#..####..####..####..####..###
#..#..#.....#.....#........#..#.....#..#.....#.....#..#..###
#..#..#.....#.....#........#..#.....#..#.....#.....#..#..###
#..#..####..#..#..##########..####..#..#..####..##D#..######
#.....#.....#..#.....#.....#..#..#..#.....#.....#.....#..###
#.....#.....#..#.....#.....#..#..#..#.....#.....#..E..#..###
#######..#..#..####..#..#..#..#..#..#######..##########..###
#........#..#..#..#..#..#.....#..#.....#.....#.....#.....###
#........#..#..#..#..#..#.....#..#.....#.....#.....#.....###
#..#######..#..#..#..#..#######..#..####..####..#..#.P#..###
#..#........#.....#.....#.....#..#..#.....#.....#..#..#..###
#..#........#.....#.....#.....#..#..#.....#.....#..#..#..###
#..#######..####..#######..#..#..#..#..####..#..####..#..###
#..#.....#.....#.....#.....#.....#..#..#..#..#........#..###
#..#.....#.....#.....#.....#.....#..#..#..#..#........#..###
#..#..#..##########..####..#..####..#..#..#..##########..###
#..#..#...........#..#.....#..#.....#..#.....#........#..###
#..#..#...........#..#.....#..#.....#..#.....#........#..###
#..#..##########..#..#..#..####..####..#..####..####..#..###
#.....#........#.....#..#..#.....#.....#.....#..#..#.....###
#.....#........#.....#..#..#.....#.....#.....#..#..#.....###
#..##....#..#..#######..#..#..####..##########..#..####..###
#..##....#..#...........#..#...M.#.....#........#........###
#..##....#..#...........#..#.....#.....#......M.#........###
#..##....#..####..#######..####..####..#..#######..#########
#..##M...#.....#..#...........#.....#..#.....#...........###
#..##....#M....#..#...........#.....#..#.....#...........###
#..##....####..#..####..##########..#..#..#..##########..###
#...........#..#.....#.....#........#..#..#....M#.M#.....###
#...........#..#.....#.....#........#..#..#.....#..#.....###
##########..#..####..#######..#######..#..####..#..#..######
#........#..#.....#..#........#...K.#..#..#.....#..#.....###
#........#..#.....#..#........#.....#..#..#.....#..#.....###
#..#..####..#######..#..#######..#..#..####..####.M####..###
#..#.................#...M.......#......M....#...........###
#..#.............M...#...........#...........#...........###
############################################################
############################################################
############################################################